border_size=1
usage=map

Rb, Rb, Rb, Rb, Rb, Rb, Rb, Rb, Rb, Rb, Ch, Ss, Ss, Ss, Ss, Ss, Ss^Esd, Ss, Gll^Ftr, Ww, Ww, Wo, Wo, Wo, Wo, Ww, Gll^Ftr
Rb, Rb, Kh, Ch, Rrc, Rb^Es, Ch, Ch, Ch, Rb^Es, Rb, Ch, Ch, Ss^Es, Chs^Dr, Ss, Gll^Ftr, Gll^Ftr, Ww^Ewf, Ww, Ww, Wo, Wo, Wo, Wo, Ww^Es, Gll^Ftr
Rb, Ch, Ch, Ch, Rb, Rrc, Ch, Kh, Ch, Rb^Es, Rb, Ch, Ch, Ss, Ss^Vhs, Ss, Ss, Ss^Es, Ww, Ww, Wo, Wo, Wo, Wo, Wo, Ww, Ww
Rb, Rr^Vhc, Rb^Es, Rb, Rrc, Rrc, Rb, Ch, Rrc, Rrc, Rrc, Ch, Ss^Es, Ww^Ewl, Ss^Efm, Ss^Esd, Ww, Ww, Wo, Wo, Wo, Wo, Wo, Wo, Wo, Wo, Wo
Ch, Rb, Rb, Rb, Rrc, Rb, Rr^Vhc, Rb, Rrc, Rb, Ch, Kh, Wwrg, Ww, Ww, Ww, Wo, Wo, Wo, Wo, Wo, Wo, Wo, Wo, Wo, Wo, Wo
Ch, Ch, Kh, Rrc, Rrc, Ch, Kh, Ch, Wog, Ch, Wwrg, Wog, Wo, Wo, Wo, Wo, Wo, Wo, Wo, Wo, Wo, Wo, Wo, Wo, Wo, Wo, Wo
Ss, Ss^Vhs, Wo, Wog^Es, Wog^Bw/, Rrc, Wog, Wwrg, Wog, Wog, Wo, Wo, Wo, Wo, Wo, Wo, Wo, Wo, Wo, Wo, Wo, Wo, Wo, Wo, Wo, Wo, Wo
Ww^Ewl, Ww^Ewl, Wo, Wo, Wo, Wog, Wo, Wo, Wo, Wo, Wo, Wo, Wo, Wo, Wo, Wo, Wo, Wo, Wo, Wo, Wo, Wo, Wo, Wo, Wo, Wo, Wo
Wo, Wo, Wo, Wo, Wo, Wo, Wo, Wo, Wo, Wo, Wo, Wo, Wo, Wo, Wo, Wo, Wo, Wo, Wo, Wo, Wo, Wo, Wo, Wo, Wo, Wo, Wo
Wo, Wo, Wo, Wo, Wo, Wo, Wo, Wo, Wo, Wo, Wo, Wo, Wo, Wo, Wo, Wo, Wo, Wo, Wo, Wo, Wo, Wo, Wo, Wo, Wo, Wo, Ww
Wo, Wo, Wo, Wo, Wo, Wo, Wo, Wo, Wo, Wo, Wo, Wo, Wo, Wo, Wo, Wo, Wo, Wo, Wo, Wo, Wo, Wo, Wo, Wo, Wo, Wo, Ww
Wo, Wo, Wo, Wo, Wo, Wo, Wo, Wo, Wo, Wo, Wo, Wo, Wo, Wo, Wo, Wo, Wo, Wo, Wo, Wo, Wo, Wo, Wo, Wo, Wo, Wo, Ww
